5 5
1 0 0 0 0
0 0 0 0 4
3 0 0 0 5
0 0 0 0 0
0 0 0 0 4
