50 20
0 0 0 0 0 0 0 0 0 0 0 0 0 0 0 0 0 0 0 0 
0 0 0 0 0 0 0 0 0 0 0 0 0 0 0 0 0 0 0 0 
0 0 1 0 0 0 0 0 0 0 0 0 0 0 0 0 0 0 0 0 
4 4 4 4 4 4 4 4 0 0 0 0 0 0 0 0 0 8 0 0 
5 5 5 5 5 5 5 5 0 0 0 0 0 0 6 6 6 6 6 6 
5 5 5 5 5 5 5 5 0 0 0 0 0 0 6 6 6 6 6 6 
7 0 0 0 0 0 0 0 0 0 0 0 0 0 0 0 0 0 0 7 
5 0 0 0 0 0 0 0 0 0 0 0 11 0 0 0 0 0 0 0 
5 0 0 0 0 0 0 0 0 0 0 0 0 0 6 0 0 0 0 9 
5 0 0 0 0 0 0 0 10 0 0 0 0 0 6 0 0 0 0 0 
5 0 0 0 0 0 0 0 4 4 4 4 4 4 6 8 0 0 0 0 
5 0 0 0 0 0 0 0 5 5 5 5 5 5 6 6 6 6 6 6 
5 0 0 0 0 0 0 0 5 5 5 5 5 5 6 6 6 6 6 6 
5 0 0 0 0 0 0 0 0 0 0 0 0 0 0 0 0 9 0 7 
5 0 0 0 0 0 0 0 0 0 0 0 0 0 0 0 0 0 0 0 
5 0 0 0 0 0 0 0 0 0 0 10 0 0 10 0 0 0 11 0 
5 0 0 0 0 0 0 6 6 6 6 6 6 6 6 6 6 0 0 0 
5 0 0 0 0 0 0 6 6 6 6 6 6 6 6 6 6 6 6 6 
4 0 0 0 0 0 0 0 0 0 0 0 0 0 0 0 0 0 0 6 
5 0 0 0 0 0 0 0 0 0 0 0 0 0 0 0 0 0 0 6 
5 0 0 0 4 0 0 10 0 0 0 0 0 0 0 0 0 0 0 6 
5 0 0 0 5 4 4 4 4 4 4 4 4 4 0 0 0 0 0 6 
5 0 0 0 0 0 0 0 0 0 0 7 5 5 0 0 0 0 0 6 
5 0 0 0 0 0 0 9 0 0 0 0 5 5 0 0 0 0 0 6 
5 0 0 0 11 0 0 0 0 0 0 0 5 5 0 0 0 10 0 6 
5 0 0 0 0 0 0 0 10 0 0 8 5 5 0 0 0 6 6 6 
5 0 0 0 4 4 4 4 4 4 4 4 5 5 0 0 0 0 7 6 
5 0 0 0 5 5 7 0 0 0 0 7 5 5 0 11 0 0 0 6 
5 0 0 0 5 5 0 0 0 0 0 0 5 5 0 0 0 0 0 6 
5 0 0 0 5 5 0 0 11 0 0 0 5 5 8 0 0 0 0 6 
5 0 0 0 5 5 0 0 0 0 12 0 5 5 4 4 0 0 0 6 
5 10 0 0 0 14 0 0 0 0 0 0 5 5 7 0 0 0 0 6 
5 4 4 4 4 4 4 4 4 4 4 4 5 5 0 0 0 0 0 6 
0 0 0 0 0 0 0 0 0 0 0 0 0 0 0 0 0 0 0 6 
0 0 0 0 0 0 0 0 0 0 0 0 0 0 0 0 0 0 0 6 
0 0 0 6 6 6 6 0 0 0 6 6 6 6 6 6 6 6 6 6 
0 0 0 6 6 6 6 0 0 0 6 7 0 0 0 0 0 0 7 6 
0 0 0 6 6 6 6 0 0 0 6 0 9 0 0 0 0 0 0 6 
0 0 0 6 6 6 6 0 0 0 6 0 0 0 0 0 11 0 0 6 
0 11 0 6 6 6 6 0 0 0 6 0 0 8 0 0 0 0 0 6 
0 0 0 7 6 7 0 0 0 0 6 6 6 6 6 6 0 0 0 6 
0 0 0 0 6 0 0 0 0 0 0 0 0 0 0 0 0 0 0 6 
10 10 9 0 6 0 0 0 0 0 0 0 0 0 0 0 0 0 0 6 
6 6 6 6 6 0 11 0 0 0 0 0 0 0 0 0 0 0 0 6 
6 7 0 0 0 0 0 0 0 10 0 0 0 0 8 0 0 0 0 6 
6 0 0 0 0 0 0 0 0 4 4 4 4 4 4 4 0 0 0 6 
6 0 0 0 0 0 0 0 0 4 4 4 4 4 4 4 4 4 4 6 
6 0 0 0 0 0 0 0 0 0 0 0 0 0 0 0 0 0 0 6 
6 0 0 0 0 8 0 0 0 0 0 10 0 0 0 0 0 0 0 13 
6 4 4 4 4 4 4 4 4 4 4 4 4 4 4 4 4 4 4 4 
images/game/backgrounds/04_background.jpg