11 60
0 0 0 0 0 0 0 0 0 0 0 0 0 0 0 6 6 6 6 6 6 6 6 6 6 7 7 7 7 7 7 7 7 7 7 4 4 4 4 4 4 7 0 0 7 0 0 0 0 0 6 6 6 6 6 6 6 7 7 7 
0 0 0 0 0 0 0 0 0 0 0 0 0 0 0 0 0 0 0 0 6 6 6 6 6 0 0 0 0 0 0 0 11 0 0 5 5 5 5 5 5 7 0 0 0 0 0 0 0 12 6 0 0 0 0 0 6 7 7 7 
0 0 0 0 0 6 6 6 0 0 0 0 0 0 0 0 0 0 0 0 6 6 6 6 6 0 0 0 0 9 0 0 0 0 0 0 0 0 0 0 0 7 0 0 0 0 8 8 8 0 6 0 0 0 0 0 6 7 7 7 
1 0 0 6 6 7 7 7 6 6 0 0 0 0 9 0 0 0 0 0 6 6 6 6 6 11 0 0 0 6 6 6 0 0 0 0 0 0 0 0 0 0 0 0 0 0 6 6 6 6 0 0 0 0 0 0 14 7 7 7 
7 7 6 6 0 0 0 0 0 6 6 0 0 0 6 6 6 0 0 0 0 0 0 0 0 0 0 0 0 0 0 0 0 0 0 0 0 0 0 0 0 0 0 0 0 0 0 0 0 0 0 0 0 6 6 6 6 4 4 4 
7 7 6 6 0 11 11 0 0 6 6 0 0 0 0 0 0 0 0 0 0 0 0 0 0 0 0 0 0 0 0 0 0 0 0 0 0 8 6 6 6 6 6 0 0 0 0 0 0 0 0 0 0 6 6 6 6 5 5 5 
7 7 6 6 11 11 11 11 0 6 6 0 0 0 0 0 0 0 0 0 0 0 0 0 0 0 0 0 0 0 0 0 0 0 0 0 8 6 6 6 6 6 6 6 6 0 0 0 0 0 6 6 6 6 6 6 6 5 5 5 
7 7 6 6 11 11 11 11 0 6 6 0 0 0 0 0 0 0 0 0 8 8 8 8 0 0 0 0 0 0 0 0 0 0 0 0 6 6 6 6 6 6 6 6 6 6 6 0 0 0 0 0 0 0 0 0 6 5 5 5 
7 7 6 6 0 11 11 0 0 6 6 0 0 0 10 10 10 0 0 0 6 6 4 4 4 4 4 4 4 4 4 4 0 0 0 0 6 6 6 6 6 6 6 6 6 6 6 6 6 0 0 0 0 0 0 0 13 5 5 5 
7 7 6 6 0 0 0 0 0 6 6 8 8 8 8 8 8 8 8 8 6 5 5 5 5 5 5 5 5 5 5 5 0 0 0 10 6 6 6 6 6 6 6 5 5 5 5 5 5 5 5 5 5 5 5 5 5 5 5 5 
8 8 6 6 8 8 8 8 8 6 6 6 6 6 6 6 6 6 6 6 6 5 5 5 5 5 5 5 5 5 5 5 5 5 5 5 6 6 6 6 6 6 5 5 5 5 5 5 5 5 5 5 5 5 5 5 5 5 5 5 
images/game/backgrounds/01_background.jpg