11 20
6 6 6 6 6 6 6 6 6 6 6 6 6 6 6 6 6 6 6 6 
6 0 0 0 0 0 0 0 0 0 0 0 0 0 0 0 0 0 0 6 
6 0 0 0 0 0 0 0 0 0 0 0 0 0 0 0 0 0 0 6 
6 0 0 0 0 0 0 0 0 0 0 0 0 0 0 0 0 0 0 6 
6 0 0 0 0 0 0 0 0 0 0 0 0 0 0 0 0 0 0 6 
6 0 0 0 0 0 0 0 11 0 0 0 0 0 0 7 0 0 0 6 
6 1 0 0 8 9 0 0 0 0 10 0 0 12 0 7 0 0 0 13 
6 4 4 4 4 4 4 4 4 4 4 4 4 4 4 4 4 4 4 6 
6 0 0 0 0 0 0 0 0 0 0 0 0 0 0 0 0 0 0 6 
6 0 0 0 0 0 0 0 0 0 0 0 0 0 0 0 0 0 0 6 
6 6 6 6 6 6 6 6 6 6 6 6 6 6 6 6 6 6 6 6 
images/game/backgrounds/01_background.jpg